1111111111111111111111
1000000000000000000011
1000000000000000000011
1111000000E00000000001
1111111100000000000011
1010101010100101010101
11P1111111111111111111
1111111111110111111111
11C1111111111111111111
1111111111111111111111
