111111111111111111111111111111
100C1100C0100000000100000100E1
1000100000100C0010000000000001
1P0000000000000000001000000001
1000010000000C0001000000C10001
100100000100000100000100000001
111111111111111111111111111111

