11111111111111111111111
100C0000000000000000001
10000000000000000000001
100000000000000000E0001
10P00000000000000000001
11111111111111111111111
