11111111111111
10000000000001
10010000000001
101000P00C0001
100100000C0001
100000000000E1
11111111111111
