11111111111111
10000000000001
100000C0000001
100C00P00C0001
100C00000C0001
100C00000CE001
11111111111111
