11111111111111
1E00000010P001
100000C0011111
100C00000C0001
11111111111111
