111111
100P01
10C001
100P11
111111