111111111
1000100C1
1P0001E11
1000000C1
111111111
