1111111111111111111111
1        0000        1
1      00000E00      1
1     0000000000     1
1    000000C000P00   1
1     0000000000     1
1      00000000      1
1       000000       1
1111111111111111111111