111111
100P01
1000C1
10E0E1
111111