1111111
1000P01
1000C01
1111110