111111111
1000001C1
1P0000E11
1000000C1
111111111
