111111
100001
1000C1
1000P1
111111