111111
100P01
10P0C1
1000E1
111111