111111111111111
1      C      1
1     000     1
1    000P0    1
1   000000E   1
111111111111111