111111111111111111
10000000P00C000001
100000E000000C0001
11100000C000100001
111111111111111111111